                             ,..,                   ..              
        ~:---:~~!!;,.-.,,*..==$,...-; ;!===$=, *=*=-,,...:;:$=.       
        .           ..  .!*$   ,,:  .*       =@. *-  ,~ !-;,  $       
       .  .;;-   *: -*!-  *!    ! ;  .=      =@:.-.:, !; -    $       
       ,       .;,.,      *!:    ! ..  $     =$*~ ; = -*      =       
       ;, .~-- - ~.:      ** ~  . ! ;   @.  .=@ .* #  ~$.     =       
       ;, ~   ;: $ *$*!!:~.~=!!;~~;= * ; -~--,  .;*;!!.!$**=~!~       
       =.~  -~..=.,,,,-- .,,,---.,,:#~  ~    .!.,~,, ,--,,,=.-:       
       !    ,.,;*; ,.   -*....;@:..-#=$  ~.-*.!,.,. :*...   =~,       
       *-  ;  ~.;*     ,~;. -= .!$==, :**,.:.;  :@*#;@@@*   **.       
       !  !   : ;-      :$ # ~$@@$@=#@  *,.,,  **  #  :$!!  =*.       
       * !!   . =:      ~$*,,@@@@###@$@;.~;,. ~#   #   .=,  ;*:       
       =!#;=#$#$,*=*=!$#~;.,@@@@@####$#$;,,*$#@* : @   .!,#@= ;     ..
       =$:!**=.!!!***~ ;!.-@@@@@@@@@@@@@@*~~;*.* : #   . ~ :*!*.      
       * ~ ,;.,- -#  $;#;,@@@@@@@@@@@@@@@@!$!* * : #   . $-=  .,      
        - :  ..   ~  #!,,@@@@@@@@@@@@@@@@@@:,= * : #   ,.:;!  .-      
        !,   ..   -  #$$#@@@@@@@@@@@@@@@@@@@ ; * ; @  .,.,:~~  ~      
       .     .,.  .  =! @@@@@@@@@@@@@@@@@@@@;~ *   #  .,, @ @; ~      
        =!;;;~ !*=*!!~.*@@@@@@@@@@@@@@@@@@@@@  *   @   ,, @ @!,       
        #@~!!!==@:~=$# @@@@@@@@@@@@@@@@@@@@@@  * . #   ,, -.!#        
          ;.;   ,!#  ! @@@@@@@@@@@@@@@@@@@@@@ .* . #-  ,.  :.,.       
       ,  :!     :*  ! @@@@@@@@@@@@@@@@@@@@@@ ,* . @-  ,.  *,:-       
       ~  ;#     :*  * @@@@@@@@@@@@@@@@@@@@@@ ,*.. @-  ,.  !,:;       
       ,  ;;     !$  * @@@@@@@@@@@@@@@@@@@@@@ ,! . #,  ,~  !.:;       
        $! !*:,~   ==$ $@@@@@@#@@@@@@@@@@@@@@.-!   $-  ,!  =.$        
        ~!~*=*= =;!$:= $@*$$@#$#@@@@@@@@@@@@@. !   *   ,;  =.#*       
        !-    ..;  ! ;,#$**@=$#=@@@@@@@@@@@@@, ;   =   ,~  = !#       
        *~    .,:  ,,*:#@@@@@@@@@@@@@@@@@@@@@#$$=!;#.  ,.  = !=       
    .   *.     .,   :=:#########@@@@@@@@@@@@@.@  . .,;!=$##=.!!       
        !.  ,-:.     *;@@@@@@@@@@@@@@@@@@@@@@~-     ~ !  ; *~=$       
        ,~-.    .~::-=!#@@@@@@@@@@@@@@@@@@@@@,!#*=#$:~~- . !~*        
        *;;*--;!$=.;-$*#@@@@@@@@@@@@@@@@@@@@@  =   @ ..::*#!:;$       
        $ ;-    !;,  *,@@@@@@@@@@@@@@@@@@@@@@ -=  ~@  .-.  !;;!       
        = :~    #~.  ; #@@@@@@@@@@@@@@@@@@@@@.*=  :@ ,--.  !~;~       
        ! ;-   - !   ! @@@@@@@@@@@@@@@@@@@@@@ *=  :@ ,,-.  *-!~       
        $,:,,=~*~$ -,=;@@@@@@@@@@@@@@@@@@@@@@ -=. :@ ,,, : * *!       
        ,. .. .    ..=!@@@@@@@@@@@@@@@@@@@@@@  =. ;@ ,-, ~ ! :!       
        =.-,,=!*~!~,-*;@@@@@@@@@@@@@@@@@@@@@@. !  ;@   -.~ ! =,       
        =*-       !  ! @@@@@@@@@@@@@@@@@@@@@@. ;. :#   ~ - * #,.      
        !  !~ *~=.,  ; #@@@@@@@@@$==@@@@@@@$@. !  :@   -., ! $,.      
        ;*      ...  ; #@@@@@@@@@$*@**$*@*$#*. !   #-  -.- ! @..      
       ~*   .,-   !;;= #@@@@@@@@@#@=#@=@#@@$@- *   =,  ,., * !*       
       ==;;!!=!===    !~                     =#@@*~=   ,   = :        
                                           .    ,~=@#$=!   * ~ .      
                                                      :=$@=*~~        